000000000000000
020020000000000
000000000000000
202000000000000
000000000000000